Always on Display :           pm uninstall --user 0 com.oneplus.aod
Android System WebView :      pm uninstall --user 0 com.google.android.webview
Black Overlay (OP launcher) : pm uninstall --user 0 net.oneplus.launcher.black.overlay
Bluetooth Midi Service : 	  pm uninstall --user 0 com.android.bluetoothmidiservice
Calculator :                  pm uninstall --user 0 com.oneplus.calculator
Camera :                      pm uninstall --user 0 com.oneplus.camera
Chrome :                      pm uninstall --user 0 com.android.chrome
Cne App	:					  pm uninstall --user 0 com.qualcomm.qti.cne
Digital Wellbeing :           pm uninstall --user 0 com.google.android.apps.wellbeing
Dolby Atmos :                 pm uninstall --user 0 com.oneplus.sound.tuner
Emergency Rescue :			  pm uninstall --user 0 com.android.emergency
Face Unlock :                 pm uninstall --user 0 com.oneplus.faceunlock
Game Space :                  pm uninstall --user 0 com.oneplus.gamespace
Gboard :                      pm uninstall --user 0 com.google.android.inputmethod.latin
Google Play Services :        pm uninstall --user 0 com.google.android.gms
Google Play Services for AR : pm uninstall --user 0 com.google.ar.core	
Google Services Framework :   pm uninstall --user 0 com.google.android.gsf
Key Chain :					  pm uninstall --user 0 com.android.keychain
NFC Service :                 pm uninstall --user 0 com.android.nfc
OnePlus Launcher :            pm uninstall --user 0 net.oneplus.launcher
Oneplus Account :             pm uninstall --user 0 com.oneplus.account
Oneplus Clock :               pm uninstall --user 0 com.oneplus.deskclock
Oneplus Gallery :             pm uninstall --user 0 com.oneplus.gallery
Play store  :                 pm uninstall --user 0 com.android.vending
SecureElementApplication :	  pm uninstall --user 0 com.android.se
User Dictionary	:			  pm uninstall --user 0 com.android.providers.userdictionary
White Overlay (OP launcher) : pm uninstall --user 0 net.oneplus.launcher.white.overlay
Work Profile :				  pm uninstall --user 0 com.android.managedprovisioning
Zen Mode :                    pm uninstall --user 0 com.oneplus.brickmode
Google One App :              pm uninstall --user 0 com.google.android.apps.subscriptions.red
